30
18
..............................
..............................
..............................
..............................
..............................
..............................
..............................
..............................
..............................
..............................
..............................
..............................
..............................
.S.QFVOY......................
WWWWWWWWWWW...................
XXXXXXXXXXX...................
XXXXXXXXXXX...................
XXXXXXXXXXX...................