.................................................
.................................................
.................................................
.................................................
.................................................
.................................................
.................................................
.................................................
.................................................
.................................................
.S...............................................
.WW..............................................
.WWX..........................WWWWWWWWWWWWWWWWWWW
.XXXX.....WWW.........WWW..WWWXXXXXXXXXXXXXXXXXXX
WWWWWWWWWWXXXWWWWWWWWWXXXWWXXXXXXXXXXXXXXXXXXXXXX
XXXXXXXXXXXXXXXXXXXXXXXXXXXXXXXXXXXXXXXXXXXXXXXXX
XXXXXXXXXXXXXXXXXXXXXXXXXXXXXXXXXXXXXXXXXXXXXXXXX
XXXXXXXXXXXXXXXXXXXXXXXXXXXXXXXXXXXXXXXXXXXXXXXXX