.................................................
.................................................
.................................................
.................................................
.................................................
.................................................
.................................................
.................................................
..........XXX....................................
................XX...............................
............S....................................
.WW..............................................
.WW...........................WWWWWWWWWWWWWWWWWWW
..........WWW.........WWW..WWWXXXXXXXXXXXXXXXXXXX
WWWWWWWWWWXXXWWWWWWWWWXXXWWXXXXXXXXXXXXXXXXXXXXXX
XXXXXXXXXXXXXXXXXXXXXXXXXXXXXXXXXXXXXXXXXXXXXXXXX
XXXXXXXXXXXXXXXXXXXXXXXXXXXXXXXXXXXXXXXXXXXXXXXXX
XXXXXXXXXXXXXXXXXXXXXXXXXXXXXXXXXXXXXXXXXXXXXXXXX