.................................................
.................................................
.................................................
.................................................
.................................................
.................................................
.................................................
.................................................
.................................................
...............XX................................
..S..............................................
.WWW...........XX................................
.WWW..........................WWWWWWWWWWWWWWWWWWW
....X.....WWW.........WWW..WWWXXXXXXXXXXXXXXXXXXX
WWWWWWWWWWXXXWWWWWWWWWXXXWWXXXXXXXXXXXXXXXXXXXXXX
XXXXXXXXXXXXXXXXXXXXXXXXXXXXXXXXXXXXXXXXXXXXXXXXX
XXXXXXXXXXXXXXXXXXXXXXXXXXXXXXXXXXXXXXXXXXXXXXXXX
XXXXXXXXXXXXXXXXXXXXXXXXXXXXXXXXXXXXXXXXXXXXXXXXX